1111111111111
1C01CC00000C1
10C0010111111
1P0000E000001
1111111111111