1111111111111111111111111111111111
100111111000000C00000C000000000001
1010010100100101111001000110010101
1010010010101010001C01000000010101
100000000C00C000001000000000C00001
100000000E00000000C000001111110001
1000111000000101010000000C00000001
1000000111110000001000000000000001
10C0000000001000000000011000000001
1000000000000100000000000000000001
10000000000000010111111100C0000001
100001111000000000CC0P010000000001
1111111111111111111111111111111111