11111111111111111
100000000100000C1
101001010E1000101
10100100101010101
100000000C000P001
100C0000100011101
11111111111111111